########################
*                      #
###################### #
###################### #
###################### E
########################