#########################
S______________________##
#_######_#############_##
#_#__###_####________#_##
#___####______######____+
#########################