#########################
*                      ##
######## ############# ##
########    ########## ##
###########             E
#########################