#########################
*                      ##
# ###### ############# ##
# #  ### ####        # ##
#   ####      ######    E
#########################