#########################
*                      ##
# ###### ############# ##
# #  ### ####        # ##
#   ####      ######    +
#########################