#############################
S___________________________#
####_######################_#
####_######################_#
####1######################_#
###########################_#
###########################_#
###########################_#
###########################_#
###########################_#
###########################_#
####################1_______#
###########################_#
###########################+#
#############################